111111111111111111111111111111111111111111111111111111
111111111111111111111111111111111111111111111111111111
111111111111111111111111111111111111111111111111111111
111111111111111111111111100000000000011111111111111111
1111111111111100000000001000L0001000011111111111111111
11111111111111000L000000000LZL001000011111111111111111
1111111111111100000000001000L0001000011111111111111111
111111111111110001111111100000001111111111111111111111
110000000001110001111111100000001111111111111111111111
110000000011110001111111111111011111111111111111111111
110000000001000000011111111110001111111111111111111111
11000L000000000L00011111111110001111111111111111111111
110000000001000000011111111110001111111111111111111111
110000000001111111111111111110001111111111111111111111
110000000001111111111111111110001111111111111111111111
111111011111111111111111111110001111111111111111111111
111110001111111111111111111000l00011111111111111111111
111110001111111111111111111110001111111111111111111111
111110001111111111111111111110001111111110000000000111
111110001111111111111111111110001111111110012345600111
111110001111111111111111111110001111111110000000000111
11111000111111111111111111111000111111111000ABSJL00111
111110001111111111111111111111011111111110000000000111
114554045411111111111111111100000111111111111101111111
14S000000041111111111111110000L00001111111111101111111
144000L00004336333633363310000000001111111111101111111
5lA0000000003B000000000B300000000001111111111101111111
144000JL00000JJJJJJJJJ00000L00900L0P200000011101111111
1440000000003B000000000B300000000000000000011101111111
5lA00000000433633363336331000000000P200000011101111111
144000L00004111111111111110000L00001222200011101111111
14S000000041111111111111111100000111112P000P1101111111
114554045411111111111111111111011111111100011PZ1111P11
111110001111111111111111111110001111111100010000000011
111110001111111111111111111110001111111100000000000011
110030001111111111111111111110001111111100010000000011
110000L01111111111111111111100000111111111111P11111P11
110030001111111111111111111110001111111111111111111111
111110001111111111111111111110001111111111111111111111
111110000020000001111111111110001111111111111111111111
111110L0000000L000011111111111011111111111111111111111
111110000020000001111111111110001111111111111111111111
111111111111111111111111111110001111111111111111111111
111111111111111111111111111110001111111111111111111111
111111111111111111111111111110001111111111111111111111
111111111111111111111111111110001111111111111111111111
111111111111111111111111111110001111111111111111111111
111111111111111111111111111110001111111111111111111111
111111111111111111111111111110001111111111111111111111
111111111111111111111111111111011111111111111111111111
111111111111111111111111111100000111111111111111111111
111111111111111111111111111100000111111111111111111111
111111111111111111111111111100000111111111111111111111
111111111111111111111111111111111111111111111111111111
111111111111111111111111111111111111111111111111111111
