11111111111111111111111111111111111111111111111111111
11111111111111111111111111111101111111111111111111111 
11111111111111111111111110000000000001111111111111111
11111111111111000000000010000000100001111111111111111 
11111111111111000000000000000000100001111111111111111
11111111111111000000000010000000100001111111111111111 
11111111111111000111111110000000111111111111111111111
11000000000111000111111110000000111111111111111111111 
11000000000111000111111111111101111111111111111111111
11000000000100000001111111111000111111111111111111111 
11000000000000000001111111111000111111111111111111111
11000000000100000001111111111000111111111111111111111 
11000000000111111111111111111000111111111111111111111
11000000000111111111111111111000111111111111111111111 
11111101111111111111111111111000111111111111111111111
11111000111111111111111111100000001111111111111111111 
11111000111111111111111111111000111111111111111111111
11111000111111111111111111111000111111111111111111111 
11111000111111111111111111111000111111111111111111111
11111000111111111111111111111000111111111111111111111 
11111000111111111111111111111000111111111111111111111
11111000111111111111111111111101111111111111111111111 
11111101111111111111111111110000011111111111111111111
11S00000001111111111111111000000000111111111111111111 
11000000000111111111111111000000000111111111111111111
1100000000003B000000000B30000000000111111111111111111 
11000000000000000000000000000090000010000001111111111
1100000000003B000000000B30000000000000000001111111111 
11000000000111111111111111000000000010000001111111111
11000000000111111111111111000000000111110001111111111 
11S00000001111111111111111110000011111100000111111111
11111404111111111111111111111101111111110001101111101 
11111000111111111111111111111000111111110001000000001
11111000111111111111111111111000111111110000000000001 
10003000111111111111111111111000111111110001000000001
10000000111111111111111111110000011111111111101111101 
10003000111111111111111111111000111111111111111111111
11111000111111111111111111111000111111111111111111111 
11111000002000000111111111111000111111111111111111111
11111000000000000001111111111101111111111111111111111 
11111000002000000111111111111000111111111111111111111
11111111111111111111111111111000111111111111111111111 
11111111111111111111111111111000111111111111111111111
11111111111111111111111111111000111111111111111111111 
11111111111111111111111111111000111111111111111111111
11111111111111111111111111111000111111111111111111111 
11111111111111111111111111111000111111111111111111111
11111111111111111111111111111000111111111111111111111 
11111111111111111111111111111101111111111111111111111
11111111111111111111111111110000011111111111111111111 
11111111111111111111111111110000011111111111111111111
11111111111111111111111111110000011111111111111111111
11111111111111111111111111111111111111111111111111111
