11111111111111111111111111111111111111111111111111111
11111111111111111111111111111101111111111111111111111 
11111111111111111111111110000000000001111111111111111
11111111111111000000000010000000100001111111111111111 
1111111111111100000000000000Z000100001111111111111111
11111111111111000000000010000000100001111111111111111 
11111111111111000111111110000000111111111111111111111
11000000000111000111111110000000111111111111111111111 
11000000000111000111111111111101111111111111111111111
11000000000100000001111111111000111111111111111111111 
11000000000000000001111111111000111111111111111111111
11000000000100000001111111111000111111111111111111111 
11000000000111111111111111111000111111111111111111111
11000000000111111111111111111000111111111111111111111 
11111101111111111111111111111000111111111111111111111
11111000111111111111111111100000001111111111111111111 
11111000111111111111111111111000111111111111111111111
11111000111111111111111111111000111111111000000000011
11111000111111111111111111111000111111111001234560011
11111000111111111111111111111000111111111000000000011
11111000111111111111111111111000111111111000ABSJL0011
11111000111111111111111111111101111111111000000000011
11455404541111111111111111110000011111111111110111111
14S000000041111111111111110000L0000111111111110111111
11400000000433633363336331000000000111111111110111111
14A0000000003B000000000B30000000000111111111110111111
1140L0J00L000JJJJJJJJJ00000L00900L0P20000001110111111
1140000000003B000000000B30000000000000000001110111111 
14A00000000433633363336331000000000P20000001110111111
114000000004111111111111110000L0000122220001110111111 
14S000000041111111111111111100000111112P000P110111111
114554045411111111111111111111011111111100011PZ1111P1 
11111000111111111111111111111000111111110001000000001
11111000111111111111111111111000111111110000000000001 
10003000111111111111111111111000111111110001000000001
100000001111111111111111111100000111111111111P11111P1 
10003000111111111111111111111000111111111111111111111
11111000111111111111111111111000111111111111111111111 
11111000002000000111111111111000111111111111111111111
11111000000000000001111111111101111111111111111111111 
11111000002000000111111111111000111111111111111111111
11111111111111111111111111111000111111111111111111111 
11111111111111111111111111111000111111111111111111111
11111111111111111111111111111000111111111111111111111 
11111111111111111111111111111000111111111111111111111
11111111111111111111111111111000111111111111111111111 
11111111111111111111111111111000111111111111111111111
11111111111111111111111111111000111111111111111111111 
11111111111111111111111111111101111111111111111111111
11111111111111111111111111110000011111111111111111111 
11111111111111111111111111110000011111111111111111111
11111111111111111111111111110000011111111111111111111
11111111111111111111111111111111111111111111111111111




