11111111111111111111
10000000110000000001
10000000110000000001
10000000110000000001
10000000000000000001
10000000000000000001
10000000000000000001
10000000000000000001
10000000111000000001
10000111111000000001
10000111111000000001
10000000111000000001
10000000000000000001
10000000000000000001
10000000000000000001
10000000000000000001
10000000000000000001
10000000000000000001
10000000000000000001
11111111111111111111
