11111111111111111111
10000000000000000001
10000000000000000001
10000000000000000001
10000000000000000001
10000000000000000001
10000000000000000001
10000000000000000001
10012345600000000001
10000000000000000001
100ZABSJL00000000001
10000000000000000001
10000000000000000001
10000000000000000001
10000000000000000001
10000000090000000001
10000000000000000001
10000000000000000001
10000000000000000001
11111111111111111111
